10 10
1 1 1 1 1 1 1 1 0 0 
1 1 1 1 0 1 0 0 0 0 
1 0 0 1 0 0 0 0 0 0 
0 1 0 0 0 0 0 0 0 0 
1 0 0 0 0 0 0 0 0 1 
0 0 0 0 0 0 0 0 0 0 
0 0 0 0 0 0 0 0 2 2 
0 0 0 0 0 0 0 2 2 2 
0 0 0 0 0 2 2 2 2 2 
0 0 0 0 2 2 2 2 2 2 
5 5
7 5
6
1 1 0
2 2 1
3 3 2 
4 4 3
6 6 4
7 7 5

